0 0 0 0 0 0 0 0 0 0 0 0 0 0 0 0 0 0 0 0 0 0 0 0 0 0 0 0 0 0 0 0 0 0 0 0 0 0 0 0 0 0 0 0 0 0 0 0 0 0 
0 1 2 2 2 2 2 2 2 2 2 2 2 2 2 2 2 2 2 2 2 2 2 2 2 2 2 2 2 2 2 2 2 2 2 2 2 2 2 2 2 2 2 2 2 2 2 2 3 0 
0 4 5 5 5 5 5 5 5 5 5 5 5 5 5 5 5 5 5 5 5 5 5 5 5 5 5 5 5 5 5 5 5 5 5 5 5 22 5 5 5 5 5 5 5 5 5 5 6 0 
0 4 5 5 5 5 5 5 22 5 13 14 14 14 14 19 5 5 22 5 5 5 5 22 5 5 5 5 5 5 22 5 5 5 5 5 5 5 5 5 5 5 5 22 5 5 5 5 6 0 
0 4 5 22 5 5 22 5 13 14 9 17 17 17 17 7 19 5 5 5 23 5 5 5 5 5 22 5 5 5 5 5 5 5 5 5 5 5 5 5 5 5 5 5 5 5 5 5 6 0 
0 4 5 5 5 5 5 22 6 17 17 17 17 17 17 17 7 14 19 5 5 5 5 5 5 5 5 5 5 5 5 5 5 5 5 5 5 5 22 5 5 5 5 5 5 5 5 5 6 0 
0 4 5 5 5 22 5 23 6 17 17 17 17 17 17 17 17 17 4 5 23 5 5 5 5 22 5 5 5 5 5 5 22 5 5 22 5 5 5 23 5 5 5 5 5 22 5 5 6 0 
0 4 5 5 5 5 5 5 6 17 17 17 17 17 17 17 17 17 4 5 5 5 5 5 5 5 5 5 5 5 5 5 5 23 5 5 13 8 8 8 8 19 22 5 5 5 5 5 6 0 
0 4 5 5 22 5 22 5 6 17 17 17 17 17 17 17 17 17 4 5 5 5 5 5 5 5 5 5 22 5 5 5 5 5 13 8 9 17 17 17 17 4 5 5 5 5 5 5 6 0 
0 4 5 5 5 5 5 5 15 3 17 17 17 17 17 17 17 1 21 5 22 5 5 5 5 5 5 5 5 5 5 5 5 5 6 17 17 17 17 17 17 7 19 5 22 5 5 5 6 0 
0 4 5 5 5 5 5 5 5 6 17 17 17 17 17 17 17 4 5 5 5 5 5 5 5 5 5 5 5 5 5 5 5 5 6 17 17 17 17 17 17 17 4 5 5 5 5 5 6 0 
0 4 5 5 5 5 5 22 5 15 2 2 2 2 2 2 2 21 22 5 5 5 5 5 22 5 5 5 5 5 5 5 22 5 15 3 17 17 17 17 17 17 4 5 22 5 5 5 6 0 
0 4 5 5 5 5 5 5 5 5 5 5 5 5 5 5 22 5 5 5 5 5 5 5 5 5 5 5 5 22 5 5 5 5 22 6 17 17 17 17 17 1 21 23 5 5 5 5 6 0 
0 4 5 5 5 5 5 5 5 5 5 22 5 23 5 5 5 5 5 5 5 5 5 5 5 23 5 5 5 5 5 22 5 5 5 15 2 2 2 2 2 21 22 5 5 23 5 5 6 0 
0 4 5 5 5 5 5 5 5 5 5 5 5 5 5 5 5 5 5 5 5 5 5 5 5 5 5 5 5 5 5 5 5 5 23 5 5 5 5 5 5 5 5 5 5 5 5 5 6 0 
0 4 5 5 5 5 5 5 5 5 5 5 5 5 5 22 5 5 5 5 5 5 22 5 5 5 5 5 5 5 22 5 5 22 5 5 5 5 5 5 5 5 22 5 22 5 5 5 6 0 
0 4 5 5 5 5 5 5 5 5 5 5 5 5 5 5 5 5 5 5 5 5 5 5 5 5 5 22 5 5 5 5 5 5 5 5 5 23 5 5 5 5 5 5 5 5 5 5 6 0 
0 4 5 5 5 5 5 5 5 5 5 5 5 5 5 5 5 5 5 5 5 5 5 5 5 5 5 5 5 22 5 5 5 5 5 5 5 5 5 5 5 5 5 5 5 5 5 5 6 0 
0 4 5 5 5 5 22 5 5 5 22 5 5 23 5 5 5 5 5 22 5 5 5 5 5 5 5 5 5 5 5 5 5 5 5 5 5 5 5 5 5 5 5 5 5 5 5 5 6 0 
0 4 5 5 5 5 5 5 5 5 5 5 5 5 5 5 5 5 5 5 5 5 5 5 5 22 5 5 5 5 5 5 5 5 5 5 5 5 5 5 5 5 5 5 5 5 5 5 6 0 
0 4 5 5 5 5 5 5 5 5 5 5 5 5 5 5 5 5 5 5 22 5 5 5 5 5 5 5 5 5 5 5 5 5 5 5 5 5 5 5 5 5 5 5 5 5 22 5 16 0 
0 4 5 5 5 5 22 5 5 5 5 22 5 5 22 5 22 5 5 5 5 5 5 5 5 5 5 5 5 22 5 5 5 5 22 5 5 5 5 5 5 5 22 22 5 5 5 5 16 0 
0 4 22 23 5 5 5 5 5 5 5 5 5 5 5 5 5 5 5 5 5 5 5 5 5 5 22 5 5 5 5 5 5 5 5 5 5 5 5 5 5 5 5 5 5 5 22 22 16 0 
0 4 24 22 5 5 5 5 5 5 5 5 5 5 5 5 5 5 5 5 22 5 5 5 5 5 5 5 5 5 5 5 22 5 5 5 5 5 5 5 5 5 5 5 5 5 23 24 16 0 
0 4 27 5 5 5 5 5 5 5 5 5 22 5 5 5 5 5 5 5 5 5 5 5 5 5 5 5 22 5 5 5 5 5 5 5 22 5 5 5 5 5 5 22 5 5 5 25 16 0
0 4 26 22 5 5 5 5 5 5 22 5 5 5 5 5 22 5 5 5 5 5 5 5 22 5 5 5 5 5 5 5 5 5 5 5 5 5 5 5 5 5 5 5 5 5 23 26 16 0
0 4 22 23 5 5 22 5 5 5 5 5 5 5 5 5 5 5 5 5 5 5 5 5 5 5 5 5 5 5 5 5 5 5 5 5 5 5 5 5 5 5 5 5 5 5 22 22 16 0 
0 4 5 5 5 5 5 5 5 5 5 5 5 5 5 5 5 5 5 5 5 5 5 5 5 5 5 5 5 5 5 5 5 22 5 5 5 5 5 5 5 5 5 5 5 5 5 5 16 0 
0 4 5 5 5 5 5 5 5 5 22 5 5 5 5 22 5 5 5 5 5 5 5 5 5 5 5 5 5 5 5 5 5 5 5 5 5 5 5 5 5 5 5 5 5 5 5 5 16 0 
0 4 5 5 5 5 5 5 5 5 5 5 5 5 5 5 5 5 5 5 5 5 5 5 5 5 5 5 5 22 5 5 5 5 5 5 5 5 5 5 22 5 5 5 22 5 5 5 6 0 
0 4 5 5 5 5 5 5 5 5 5 5 5 5 5 5 5 5 5 5 5 5 5 5 5 5 5 5 5 5 5 5 5 5 5 5 22 5 5 5 5 5 5 5 5 5 5 5 6 0 
0 4 5 5 5 22 5 5 5 5 22 5 5 5 22 5 5 5 5 5 5 5 23 5 5 22 5 5 5 22 5 5 5 5 5 5 5 5 5 5 22 5 5 22 5 5 5 5 6 0 
0 4 5 5 5 5 5 5 5 5 5 5 22 5 5 5 5 5 5 5 5 5 5 5 5 5 5 5 5 5 5 5 22 5 5 5 5 22 5 5 5 5 5 5 5 5 5 5 6 0 
0 4 5 5 5 5 5 5 5 5 5 5 5 5 22 5 5 5 22 5 5 5 5 5 5 5 5 5 5 5 5 5 5 5 5 5 5 5 5 5 5 23 5 5 5 5 5 5 6 0 
0 4 5 5 5 5 5 5 5 5 5 5 5 5 5 5 5 5 5 5 5 5 5 5 22 5 5 5 5 5 5 5 5 5 22 5 5 5 22 5 5 5 5 5 5 5 5 5 6 0 
0 4 5 22 5 5 5 5 5 5 5 5 5 5 5 5 5 5 5 5 5 5 5 5 5 5 5 5 5 13 14 14 14 14 14 14 14 19 5 22 5 5 5 5 5 5 5 5 6 0 
0 4 5 5 5 5 5 22 5 5 5 5 5 5 5 5 5 5 5 5 5 5 5 5 5 5 5 22 13 9 17 17 17 17 17 17 17 7 19 5 5 5 5 5 5 5 5 5 6 0 
0 4 5 5 22 5 5 5 5 5 5 22 5 5 5 5 5 5 5 5 5 5 5 5 5 23 5 13 9 17 17 17 17 17 17 17 17 17 18 5 5 5 5 5 5 5 5 5 6 0 
0 4 5 5 5 5 5 5 5 5 5 5 5 5 22 5 5 5 5 22 5 5 5 5 5 13 14 9 17 17 17 17 17 17 17 17 17 17 18 5 5 5 5 5 5 5 5 5 6 0 
0 4 5 5 5 5 5 23 5 5 5 5 5 5 5 5 5 5 5 5 5 5 5 5 5 6 17 17 17 17 17 17 17 17 17 17 17 17 18 23 5 22 5 5 22 5 5 5 6 0 
0 4 5 5 5 5 5 5 5 5 5 5 5 5 5 5 5 5 5 5 5 5 22 22 5 6 17 17 17 17 17 17 17 17 17 17 17 17 18 5 5 5 5 5 5 5 5 5 6 0 
0 4 5 22 5 5 5 22 5 5 22 5 5 5 5 22 5 5 5 5 5 5 5 5 5 6 17 17 17 17 17 17 17 17 17 17 17 1 21 5 22 5 5 5 5 5 5 5 6 0 
0 4 5 5 5 5 5 5 5 5 5 5 5 5 5 5 5 5 5 5 5 5 5 5 5 6 17 17 17 17 17 17 17 17 17 17 1 21 5 5 5 5 22 5 22 5 5 5 6 0 
0 4 5 5 5 22 5 5 5 22 5 5 5 22 5 5 5 5 5 5 5 5 5 5 22 15 3 17 17 17 1 3 17 17 1 2 21 5 5 5 5 5 5 5 5 5 5 5 6 0 
0 4 5 5 5 5 22 5 5 5 5 5 5 23 22 5 5 5 5 5 5 22 5 5 5 5 15 2 2 2 21 15 2 2 21 5 22 5 5 5 5 5 5 5 5 5 5 5 6 0 
0 4 5 5 5 5 5 5 5 5 5 5 5 5 5 5 5 5 5 5 5 5 5 5 5 5 5 5 5 5 5 5 5 22 5 5 5 5 22 5 5 5 5 5 22 5 5 5 6 0 
0 7 8 8 8 8 8 8 8 8 8 8 8 8 8 8 8 8 8 8 8 8 8 8 8 8 8 8 8 8 8 8 8 8 8 8 8 8 8 8 8 8 8 8 8 8 8 8 9 0 
0 10 11 11 11 11 11 11 11 11 11 11 11 11 11 11 11 11 11 11 11 11 11 11 11 11 11 11 11 11 11 11 11 11 11 11 11 11 11 11 11 11 11 11 11 11 11 11 12 0 
0 0 0 0 0 0 0 0 0 0 0 0 0 0 0 0 0 0 0 0 0 0 0 0 0 0 0 0 0 0 0 0 0 0 0 0 0 0 0 0 0 0 0 0 0 0 0 0 0 0 
0 0 0 0 0 0 0 0 0 0 0 0 0 0 0 0 0 0 0 0 0 0 0 0 0 0 0 0 0 0 0 0 0 0 0 0 0 0 0 0 0 0 0 0 0 0 0 0 0 0 
