1 1 0 0 0 0 0 0 0 0 0 0 0 0 1 1
1 0 0 0 0 1 0 0 0 0 1 0 0 0 0 1
0 1 0 0 0 2 2 2 2 2 2 0 0 0 1 0
0 0 0 0 2 3 3 3 3 3 3 2 0 0 0 0
0 0 0 2 3 3 3 3 3 3 3 3 2 0 0 0
0 0 9 3 3 3 3 3 3 3 3 3 3 8 0 0
0 0 9 3 3 3 3 3 3 3 3 3 3 8 0 0
0 0 0 6 3 3 3 3 3 3 3 3 7 0 0 0
1 0 0 0 6 3 3 3 3 3 3 7 0 0 0 1
0 1 0 0 0 5 5 5 5 5 5 0 0 0 1 0
1 0 0 0 0 1 0 0 0 0 1 0 0 0 0 1
1 1 0 0 0 0 0 0 0 0 0 0 0 0 1 1